###########################################
#---+-####-+---#----####---#++++++++++----#
#-----####-----#-----------#++------------#
#-----####-----#-----------#++------------####
#++---####-----#####--######-----------------#
#++---------------------------------------+--#
#++---------------------------------------#--#
#-----------------------------------------#--#
#-----------------------------------------####
#############-----------------------------#
#-----------------------------------------#
#-----------#-----------------------------#
###########################################