###############
#-------------#
#-------------#
#-------------#
#-------------#
#-------------#
#------------+#
###############